xxxxxxxxxxxxxxxxxxxxxxxx
x0000000000xx0000000000x
x0002000000xx0000002000x
x0000000000000000000000x
xxxxx00000000000000xxxxx
xxxxx00000001000000xxxxx
x0000000000000000000000x
x0002000000xx0000002000x
x0000000000xx0000000000x
xxxxxxxxxxxxxxxxxxxxxxxx 