xxxxxxxxxxxxxxxxxxxxxxxx
xx000x000x000x000x0000xx
xx000x000x000x000x0000xx
x000000000000000000000xx
x0020002000200020002000x
x0000000000000000000000x
x0000000000000000000000x
x00x000x000x000x000x010x
x00x000x000x000x000x000x
xxxxxxxxxxxxxxxxxxxxxxxx 